// Level 2 - Change directions
wwwwwwwwww
w________w
w_s______w
w________w
w________w
w___wwwwww
w________w
w______d_w
w________w
wwwwwwwwww
